8 9
#########
#####. @#
#  ###  #
#  $ . ##
# $#$# ##
##   # ##
##   . ##
#########
