9 7
#######
##    #
##$   #
# . * #
# $$#.#
# #@.##
##   ##
##   ##
#######