1
#######
#@$  .#
# ##$ #
#$    #
# * * #
#.#.  #
#######